$$$ exec p1 : [./srcs/filler]
Plateau 15 17:
    01234567890123456
000 OOOOOOOOOOOOOOOO.
001 OOOOOOOOOOOOOOOO.
002 OOOOOOOOOOOOOOOO.
003 OOOOOOOOOOOOOOOO.
004 OOOOOOOOOOOOOOOO.
005 OOOOOOOOOOOOOOOO.
006 OOOOOOOOOOOOOOOO.
007 OOOOOOOOOOOOOOOO.
008 OOOOOOOOOOOOOOOO.
009 OOOOOOOOOOOOOOOO.
010 OOOOOOOOOOOOOOOO.
011 OOOOOOOOOOOOOoo..
012 ..............X..
013 .................
014 .................
Piece 2 3:
...
***
