$$$ exec p1 : [../filler]
Plateau 15 17:
    01234567890123456
000 .................
001 .OO..............
002 .................
003 .................
004 .................
005 .................
006 .................
007 .................
008 .................
009 .................
010 .................
011 .................
012 .............xx..
013 .................
014 .................
Piece 2 2:
**
**

