$$$ exec p1 : [../filler]
Plateau 15 17:
    01234567890123456
000 XXXXXXXXXXXXXXXX.
001 XXXXXXXXXXXXXXXX.
002 XXXXXXXXXXXXXXXX.
003 XXXXXXXXXXXXXXXX.
004 XXXXXXXXXXXXXXXX.
005 XXXXXXXXXXXXXXXX.
006 XXXXXXXXXXXXXXXX.
007 XXXXXXXXXXXXXXXX.
008 XOOXXXXXXXXXXXXX.
009 XXOXXXXXXXXXXXXX.
010 XXXXXXXXXXXXXXXX.
011 XXXXXXXXXXXXXXXX.
012 XXXXXXXXXXXXXXXX.
013 XXXXXXXXXXXXxx...
014 .................
Piece 7 12:
............
............
.........*..
.........*..
.........*..
.........**.
............

